"Flight Date","Flight No.",Route,"Paying Pax","Non-Paying Pax","Total Pax"
2017-01-17,"GA 270","KNO-BTH
(Domestic)","89 ",4,93
2017-01-17,"GA 270","KNO-BTH
(Domestic)","89 ",4,93
2017-01-17,"GA 121","KNO-CGK
(Domestic)","113 ",12,125
2017-01-17,"GA 121","KNO-CGK
(Domestic)","113 ",12,125
2017-01-17,"GA 197","KNO-CGK
(Domestic)","102 ",0,102
2017-01-17,"GA 197","KNO-CGK
(Domestic)","102 ",0,102
2017-01-17,"GA 195","KNO-CGK
(Domestic)","148 ",3,151
2017-01-17,"GA 195","KNO-CGK
(Domestic)","148 ",3,151
2017-01-17,"GA 191","KNO-CGK
(Domestic)","129 ",13,142
2017-01-17,"GA 191","KNO-CGK
(Domestic)","129 ",13,142
2017-01-17,"GA 189","KNO-CGK
(Domestic)","107 ",35,142
2017-01-17,"GA 189","KNO-CGK
(Domestic)","107 ",35,142
2017-01-17,"GA 187","KNO-CGK
(Domestic)","101 ",12,113
2017-01-17,"GA 187","KNO-CGK
(Domestic)","101 ",12,113
2017-01-17,"GA 185","KNO-CGK
(Domestic)","95 ",10,105
2017-01-17,"GA 185","KNO-CGK
(Domestic)","95 ",10,105
2017-01-17,"GA 183","KNO-CGK
(Domestic)","137 ",1,138
2017-01-17,"GA 183","KNO-CGK
(Domestic)","137 ",1,138
2017-01-17,"GA 181","KNO-CGK
(Domestic)","104 ",2,106
2017-01-17,"GA 181","KNO-CGK
(Domestic)","104 ",2,106
2017-01-17,"GA 123","KNO-CGK
(Domestic)","125 ",0,125
2017-01-17,"GA 123","KNO-CGK
(Domestic)","125 ",0,125
2017-01-17,"GA 7136","KNO-DTB
(Domestic)","29 ",4,33
2017-01-17,"GA 7136","KNO-DTB
(Domestic)","29 ",4,33
2017-01-17,"GA 7134","KNO-FLZ
(Domestic)","40 ",26,66
2017-01-17,"GA 7134","KNO-FLZ
(Domestic)","40 ",26,66
2017-01-17,"GA 7116","KNO-GNS
(Domestic)","54 ",0,54
2017-01-17,"GA 7116","KNO-GNS
(Domestic)","54 ",0,54
2017-01-17,"GA 7118","KNO-GNS
(Domestic)","54 ",16,70
2017-01-17,"GA 7118","KNO-GNS
(Domestic)","54 ",16,70
2017-01-17,"GA 7124","KNO-LSW
(Domestic)","1 ",40,41
2017-01-17,"GA 7124","KNO-LSW
(Domestic)","1 ",40,41
2017-01-17,"GA 266","KNO-PLM
(Domestic)","77 ",2,79
2017-01-17,"GA 266","KNO-PLM
(Domestic)","77 ",2,79
2017-01-17,"GA 850","KNO-SIN
(International)","30 ",0,30
2017-01-17,"GA 850","KNO-SIN
(International)","30 ",0,30
2017-01-17,"MI 233","KNO-KUL
(International)","142 ",0,142
2017-01-17,"MI 233","KNO-KUL
(International)","142 ",0,142
2017-01-17,"MI 237","KNO-KUL
(International)","101 ",0,101
2017-01-17,"MI 237","KNO-KUL
(International)","101 ",0,101
2017-01-17,"MH 861","KNO-SIN
(International)","79 ",2,81
2017-01-17,"MH 861","KNO-SIN
(International)","79 ",2,81
2017-01-17,"MH 865","KNO-SIN
(International)","38 ",0,38
2017-01-17,"MH 865","KNO-SIN
(International)","38 ",0,38
