"Flight Date","Flight No.",Route,"Paying Pax","Non-Paying Pax","Total Pax"
2017-02-19,"GA 648","CGK3-?
(Domestic)","97 ",9,106
2017-02-19,"GA 646","CGK3-AMQ
(Domestic)","73 ",11,84
2017-02-19,"GA 530","CGK3-BDJ
(Domestic)","45 ",1,46
2017-02-19,"GA 532","CGK3-BDJ
(Domestic)","106 ",13,119
2017-02-19,"GA 536","CGK3-BDJ
(Domestic)","141 ",8,149
2017-02-19,"GA 538","CGK3-BDJ
(Domestic)","112 ",9,121
2017-02-19,"GA 528","CGK3-BDJ
(Domestic)","122 ",11,133
2017-02-19,"GA 534","CGK3-BDJ
(Domestic)","158 ",2,160
2017-02-19,"GA 298","CGK3-BKS
(Domestic)","83 ",18,101
2017-02-19,"GA 296","CGK3-BKS
(Domestic)","42 ",1,43
2017-02-19,"GA 576","CGK3-BPN
(Domestic)","109 ",9,118
2017-02-19,"GA 572","CGK3-BPN
(Domestic)","134 ",5,139
2017-02-19,"GA 566","CGK3-BPN
(Domestic)","82 ",15,97
2017-02-19,"GA 570","CGK3-BPN
(Domestic)","97 ",6,103
2017-02-19,"GA 568","CGK3-BPN
(Domestic)","86 ",59,145
2017-02-19,"GA 560","CGK3-BPN
(Domestic)","28 ",0,28
2017-02-19,"GA 562","CGK3-BPN
(Domestic)","28 ",0,28
2017-02-19,"GA 564","CGK3-BPN
(Domestic)","95 ",5,100
2017-02-19,"GA 158","CGK3-BTH
(Domestic)","93 ",4,97
2017-02-19,"GA 156","CGK3-BTH
(Domestic)","71 ",5,76
2017-02-19,"GA 154","CGK3-BTH
(Domestic)","94 ",18,112
2017-02-19,"GA 152","CGK3-BTH
(Domestic)","80 ",22,102
2017-02-19,"GA 150","CGK3-BTH
(Domestic)","33 ",1,34
2017-02-19,"GA 142","CGK3-BTJ
(Domestic)","114 ",25,139
2017-02-19,"GA 146","CGK3-BTJ
(Domestic)","112 ",19,131
2017-02-19,"GA 140","CGK3-BTJ
(Domestic)","51 ",2,53
2017-02-19,"GA 126","CGK3-DJB
(Domestic)","47 ",9,56
2017-02-19,"GA 128","CGK3-DJB
(Domestic)","114 ",23,137
2017-02-19,"GA 130","CGK3-DJB
(Domestic)","36 ",0,36
2017-02-19,"GA 134","CGK3-DJB
(Domestic)","98 ",16,114
2017-02-19,"GA 132","CGK3-DJB
(Domestic)","102 ",12,114
2017-02-19,"GA 656","CGK3-DJJ
(Domestic)","121 ",7,128
2017-02-19,"GA 420","CGK3-DPS
(Domestic)","106 ",21,127
2017-02-19,"GA 438","CGK3-DPS
(Domestic)","44 ",1,45
2017-02-19,"GA 418","CGK3-DPS
(Domestic)","130 ",3,133
2017-02-19,"GA 652","CGK3-DPS
(Domestic)","44 ",8,52
2017-02-19,"GA 400","CGK3-DPS
(Domestic)","48 ",0,48
2017-02-19,"GA 426","CGK3-DPS
(Domestic)","167 ",14,181
2017-02-19,"GA 424","CGK3-DPS
(Domestic)","63 ",2,65
2017-02-19,"GA 422","CGK3-DPS
(Domestic)","181 ",24,205
2017-02-19,"GA 414","CGK3-DPS
(Domestic)","87 ",13,100
2017-02-19,"GA 412","CGK3-DPS
(Domestic)","219 ",3,222
2017-02-19,"GA 410","CGK3-DPS
(Domestic)","139 ",16,155
2017-02-19,"GA 408","CGK3-DPS
(Domestic)","93 ",14,107
2017-02-19,"GA 404","CGK3-DPS
(Domestic)","75 ",3,78
2017-02-19,"GA 402","CGK3-DPS
(Domestic)","77 ",1,78
2017-02-19,"GA 4104","CGK3-DPS
(Domestic)","70 ",1,71
2017-02-19,"GA 268","CGK3-DTB
(Domestic)","66 ",0,66
2017-02-19,"GA 218","CGK3-JOG
(Domestic)","153 ",4,157
2017-02-19,"GA 214","CGK3-JOG
(Domestic)","144 ",11,155
2017-02-19,"GA 212","CGK3-JOG
(Domestic)","139 ",17,156
2017-02-19,"GA 210","CGK3-JOG
(Domestic)","134 ",22,156
2017-02-19,"GA 208","CGK3-JOG
(Domestic)","122 ",31,153
2017-02-19,"GA 206","CGK3-JOG
(Domestic)","122 ",13,135
2017-02-19,"GA 204","CGK3-JOG
(Domestic)","105 ",11,116
2017-02-19,"GA 202","CGK3-JOG
(Domestic)","91 ",4,95
2017-02-19,"GA 216","CGK3-JOG
(Domestic)","145 ",17,162
2017-02-19,"GA 180","CGK3-KNO
(Domestic)","103 ",4,107
2017-02-19,"GA 118","CGK3-KNO
(Domestic)","114 ",30,144
2017-02-19,"GA 122","CGK3-KNO
(Domestic)","113 ",12,125
2017-02-19,"GA 184","CGK3-KNO
(Domestic)","81 ",22,103
2017-02-19,"GA 188","CGK3-KNO
(Domestic)","113 ",23,136
2017-02-19,"GA 190","CGK3-KNO
(Domestic)","149 ",4,153
2017-02-19,"GA 192","CGK3-KNO
(Domestic)","93 ",32,125
2017-02-19,"GA 196","CGK3-KNO
(Domestic)","108 ",23,131
2017-02-19,"GA 182","CGK3-KNO
(Domestic)","96 ",5,101
2017-02-19,"GA 186","CGK3-KNO
(Domestic)","105 ",12,117
2017-02-19,"GA 456","CGK3-KOE
(Domestic)","23 ",0,23
2017-02-19,"GA 452","CGK3-LBJ
(Domestic)","29 ",3,32
2017-02-19,"GA 430","CGK3-LOP
(Domestic)","142 ",8,150
2017-02-19,"GA 434","CGK3-LOP
(Domestic)","54 ",0,54
2017-02-19,"GA 432","CGK3-LOP
(Domestic)","36 ",8,44
2017-02-19,"GA 440","CGK3-LOP
(Domestic)","65 ",17,82
2017-02-19,"GA 606","CGK3-MDC
(Domestic)","106 ",12,118
2017-02-19,"GA 602","CGK3-MDC
(Domestic)","99 ",2,101
2017-02-19,"GA 600","CGK3-MDC
(Domestic)","82 ",20,102
2017-02-19,"GA 626","CGK3-MDC
(Domestic)","104 ",23,127
2017-02-19,"GA 292","CGK3-MLG
(Domestic)","141 ",17,158
2017-02-19,"GA 290","CGK3-MLG
(Domestic)","123 ",17,140
2017-02-19,"GA 124","CGK3-PDG
(Domestic)","38 ",1,39
2017-02-19,"GA 148","CGK3-PDG
(Domestic)","103 ",25,128
2017-02-19,"GA 160","CGK3-PDG
(Domestic)","71 ",4,75
2017-02-19,"GA 162","CGK3-PDG
(Domestic)","112 ",22,134
2017-02-19,"GA 164","CGK3-PDG
(Domestic)","125 ",23,148
2017-02-19,"GA 166","CGK3-PDG
(Domestic)","111 ",24,135
2017-02-19,"GA 168","CGK3-PDG
(Domestic)","97 ",19,116
2017-02-19,"GA 138","CGK3-PGK
(Domestic)","74 ",13,87
2017-02-19,"GA 136","CGK3-PGK
(Domestic)","39 ",8,47
2017-02-19,"GA 174","CGK3-PKU
(Domestic)","84 ",25,109
2017-02-19,"GA 172","CGK3-PKU
(Domestic)","88 ",11,99
2017-02-19,"GA 178","CGK3-PKU
(Domestic)","119 ",26,145
2017-02-19,"GA 170","CGK3-PKU
(Domestic)","54 ",2,56
2017-02-19,"GA 198","CGK3-PKU
(Domestic)","96 ",28,124
2017-02-19,"GA 144","CGK3-PKU
(Domestic)","100 ",24,124
2017-02-19,"GA 176","CGK3-PKU
(Domestic)","137 ",18,155
2017-02-19,"GA 550","CGK3-PKY
(Domestic)","54 ",1,55
2017-02-19,"GA 552","CGK3-PKY
(Domestic)","96 ",21,117
2017-02-19,"GA 106","CGK3-PLM
(Domestic)","118 ",5,123
2017-02-19,"GA 108","CGK3-PLM
(Domestic)","118 ",11,129
2017-02-19,"GA 110","CGK3-PLM
(Domestic)","95 ",28,123
2017-02-19,"GA 112","CGK3-PLM
(Domestic)","120 ",26,146
2017-02-19,"GA 102","CGK3-PLM
(Domestic)","70 ",2,72
2017-02-19,"GA 114","CGK3-PLM
(Domestic)","89 ",48,137
2017-02-19,"GA 116","CGK3-PLM
(Domestic)","106 ",30,136
2017-02-19,"GA 104","CGK3-PLM
(Domestic)","71 ",24,95
2017-02-19,"GA 120","CGK3-PLM
(Domestic)","97 ",47,144
2017-02-19,"GA 622","CGK3-PLW
(Domestic)","109 ",6,115
2017-02-19,"GA 500","CGK3-PNK
(Domestic)","43 ",1,44
2017-02-19,"GA 502","CGK3-PNK
(Domestic)","69 ",7,76
2017-02-19,"GA 504","CGK3-PNK
(Domestic)","71 ",26,97
2017-02-19,"GA 510","CGK3-PNK
(Domestic)","75 ",22,97
2017-02-19,"GA 514","CGK3-PNK
(Domestic)","87 ",11,98
2017-02-19,"GA 228","CGK3-SOC
(Domestic)","115 ",21,136
2017-02-19,"GA 224","CGK3-SOC
(Domestic)","96 ",16,112
2017-02-19,"GA 226","CGK3-SOC
(Domestic)","125 ",11,136
2017-02-19,"GA 222","CGK3-SOC
(Domestic)","69 ",18,87
2017-02-19,"GA 220","CGK3-SOC
(Domestic)","54 ",0,54
2017-02-19,"GA 246","CGK3-SRG
(Domestic)","122 ",25,147
2017-02-19,"GA 244","CGK3-SRG
(Domestic)","153 ",3,156
2017-02-19,"GA 242","CGK3-SRG
(Domestic)","130 ",14,144
2017-02-19,"GA 240","CGK3-SRG
(Domestic)","94 ",11,105
2017-02-19,"GA 238","CGK3-SRG
(Domestic)","93 ",19,112
2017-02-19,"GA 236","CGK3-SRG
(Domestic)","93 ",28,121
2017-02-19,"GA 234","CGK3-SRG
(Domestic)","127 ",12,139
2017-02-19,"GA 230","CGK3-SRG
(Domestic)","59 ",2,61
2017-02-19,"GA 448","CGK3-SUB
(Domestic)","112 ",22,134
2017-02-19,"GA 302","CGK3-SUB
(Domestic)","62 ",0,62
2017-02-19,"GA 304","CGK3-SUB
(Domestic)","51 ",0,51
2017-02-19,"GA 306","CGK3-SUB
(Domestic)","58 ",2,60
2017-02-19,"GA 328","CGK3-SUB
(Domestic)","136 ",37,173
2017-02-19,"GA 326","CGK3-SUB
(Domestic)","113 ",6,119
2017-02-19,"GA 324","CGK3-SUB
(Domestic)","134 ",3,137
2017-02-19,"GA 322","CGK3-SUB
(Domestic)","111 ",10,121
2017-02-19,"GA 320","CGK3-SUB
(Domestic)","144 ",2,146
2017-02-19,"GA 318","CGK3-SUB
(Domestic)","195 ",8,203
2017-02-19,"GA 316","CGK3-SUB
(Domestic)","147 ",8,155
2017-02-19,"GA 308","CGK3-SUB
(Domestic)","119 ",24,143
2017-02-19,"GA 310","CGK3-SUB
(Domestic)","112 ",2,114
2017-02-19,"GA 312","CGK3-SUB
(Domestic)","81 ",26,107
2017-02-19,"GA 314","CGK3-SUB
(Domestic)","149 ",35,184
2017-02-19,"GA 282","CGK3-TJQ
(Domestic)","56 ",1,57
2017-02-19,"GA 284","CGK3-TJQ
(Domestic)","58 ",38,96
2017-02-19,"GA 72","CGK3-TKG
(Domestic)","77 ",20,97
2017-02-19,"GA 70","CGK3-TKG
(Domestic)","23 ",1,24
2017-02-19,"GA 74","CGK3-TKG
(Domestic)","85 ",32,117
2017-02-19,"GA 76","CGK3-TKG
(Domestic)","101 ",31,132
2017-02-19,"GA 78","CGK3-TKG
(Domestic)","89 ",34,123
2017-02-19,"GA 68","CGK3-TKG
(Domestic)","102 ",37,139
2017-02-19,"GA 80","CGK3-TKG
(Domestic)","29 ",0,29
2017-02-19,"GA 286","CGK3-TNJ
(Domestic)","72 ",8,80
2017-02-19,"GA 668","CGK3-TRK
(Domestic)","35 ",2,37
2017-02-19,"GA 642","CGK3-UPG
(Domestic)","142 ",0,142
2017-02-19,"GA 608","CGK3-UPG
(Domestic)","125 ",5,130
2017-02-19,"GA 610","CGK3-UPG
(Domestic)","154 ",7,161
2017-02-19,"GA 604","CGK3-UPG
(Domestic)","72 ",0,72
2017-02-19,"GA 616","CGK3-UPG
(Domestic)","152 ",11,163
2017-02-19,"GA 654","CGK3-UPG
(Domestic)","60 ",2,62
2017-02-19,"GA 618","CGK3-UPG
(Domestic)","108 ",12,120
2017-02-19,"GA 650","CGK3-UPG
(Domestic)","120 ",15,135
2017-02-19,"GA 640","CGK3-UPG
(Domestic)","127 ",12,139
2017-02-19,"GA 614","CGK3-UPG
(Domestic)","155 ",5,160
