"Flight Date","Flight No.",Route,"Paying Pax","Non-Paying Pax","Total Pax"
2017-04-29,"GA 270","KNO-BTH
(Domestic)","85 ",1,86
2017-04-29,"GA 121","KNO-CGK
(Domestic)","83 ",13,96
2017-04-29,"GA 197","KNO-CGK
(Domestic)","108 ",1,109
2017-04-29,"GA 195","KNO-CGK
(Domestic)","52 ",1,53
2017-04-29,"GA 193","KNO-CGK
(Domestic)","70 ",0,70
2017-04-29,"GA 191","KNO-CGK
(Domestic)","83 ",6,89
2017-04-29,"GA 189","KNO-CGK
(Domestic)","125 ",4,129
2017-04-29,"GA 187","KNO-CGK
(Domestic)","104 ",2,106
2017-04-29,"GA 185","KNO-CGK
(Domestic)","86 ",12,98
2017-04-29,"GA 183","KNO-CGK
(Domestic)","125 ",1,126
2017-04-29,"GA 181","KNO-CGK
(Domestic)","119 ",0,119
2017-04-29,"GA 7136","KNO-DTB
(Domestic)","38 ",3,41
2017-04-29,"GA 7134","KNO-FLZ
(Domestic)","51 ",5,56
2017-04-29,"GA 7116","KNO-GNS
(Domestic)","54 ",7,61
2017-04-29,"GA 266","KNO-PLM
(Domestic)","85 ",1,86
2017-04-29,"MH 861","KNO-KUL
(International)","140 ",1,141
2017-04-29,"MH 865","KNO-KUL
(International)","143 ",0,143
2017-04-29,"MI 233","KNO-SIN
(International)","155 ",2,157
2017-04-29,"MI 237","KNO-SIN
(International)","77 ",0,77
